####################
#  P     O ###O   ##
#    X   #######   #
######             #
#O  O# X     #X    #
#       X    #     #
#        #####     #
####################